1 4 4 2 1 1 2 4 4 1
2 0 0 2 0 0 2 0 0 2
3 0 0 3 0 0 3 0 0 3
1 1 1 1 1 1 1 1 1 1
2 0 0 2 2 2 2 0 0 2
3 4 4 3 3 3 3 4 4 3
