3 1 3 1 2 2 1 3 1 3
2 3 2 2 3 3 2 2 3 2
1 0 0 1 2 2 1 0 0 3
2 0 0 2 1 1 2 0 0 1
3 4 4 1 2 2 1 4 4 3
2 1 3 2 3 3 2 3 1 2
